|-----------------------------------------------------------------------------|
|                                                                             |
|                                                                             |
|                        |----|                                  |-----|      |
|                  |-----|....|                              |---|.....|-|    |
|            |-----|..........|                              |...........|-|  |
|      |-----|................|                             |..............|-||
|  |---|.....................|                             |.................||
|  |.........................|                             |.................||
|  |-----------|.............|                            |..................||
|              |-------------|     |--------|             |------------------||
|                                |-|........|-----|                           |
|                              |-|................|                           |
|                              |..................|                           |
|                             |..................-|                           |
|                             |----|........|----|                            |
|   |-----------------------|      |--------|               |----------|      |
|   |.......................|                           |---|..........|-----||
|  |.......................|                          |-|....................||
|  |.....................|-|                          |.....................| |
| |....................|-|                           |.....................|  |
| |-|........|---------|                            |...........|----------|  |
|   |--------|                                      |-----------|             |
|                                                                             |
|-----------------------------------------------------------------------------|
